#separator:pipe
#html:false
#deck:JLPT N1 語彙
#notetype:Two Backs
〜宛[て]|〜あて|for, addresed to
〜合わせ|〜あわせ|to fit
〜位|〜い|nth place
〜以上|〜いじょう|since…,once…
〜一|〜いち|the top of ~
〜員|〜いん|a member of ~
〜上で|〜うえで|first doing something, then…, in the process of…
〜うちに|〜うちに|while…, in the course of…, within…
〜営|〜えい|operation, management
〜円|〜えん|Japanese Yen
〜園|〜えん|garden
〜おき|〜おき|intervals of ~, every ~
〜終わる|〜おわる|finished (something)
〜下|〜か|under
〜科|〜か|department, family subject
〜歌|〜か|song
〜化|〜か|~ise
〜家|〜か|a person that does ~ (occupation)
〜日|〜か|days
〜画|〜が|painting of ~
〜界|〜かい|world, society, circle
〜会|〜かい|meeting, gathering party, society
〜回|〜かい|times
〜海|〜かい|sea of
〜外|〜がい|out of ~
〜街|〜がい|street, district
〜階|〜かい／がい|~ storey
〜画|〜かく|stroke, plan
〜掛け|〜かけ|half~
〜ヶ月|〜かけつ|months
(お)金持ち|(お)かねもち|rich man
(お)酒|(お)さけ|liquor
(お)皿|(お)さら|plate
(お)釣[り]|(お)つり|change
～かねない|～かねない|Might happen
～がる|～がる|Feeling like
側|～がわ|Side
亜〜|あ〜|subtropical region
ああ|ああ|like that
ああ|ああ|ah
愛|あい|love, affection
相変わらず|あいかわらず|as before, as ever, as usual, as always, remain
挨拶（する）|あいさつ（する）|greet, salute
愛情|あいじょう|love, affection
合図|あいず|a signal, a sign, a cue
アイスクリーム|アイスクリーム|ice-cream
愛する|あいする|love, have an affection to, be attached to
愛想|あいそう|amiable, affable, sociable
間|あいだ|between (A and B)
間柄|あいだがら|relationship
相次ぐ|あいつぐ|successive
相手|あいて|a companion, one's partner, an opponent, an adversary, a rival, the other party
アイデア／アイディア|アイデア／アイディア|idea
あいにく|あいにく|unfortunately, unluckily
合い間|あいま|in the intervals, in one's spare time
曖昧|あいまい|unclear, vague, noncommital, ambiguous, equivocal
アイロン|アイロン|an iron
会う|あう|see, meet
合う|あう|fit, match
遭う|あう|meet, encounter, encounter difficulties
アウト|アウト|out
敢えて|あえて|dare
青|あお|blue
青い|あおい|blue
仰ぐ|あおぐ|look up
扇ぐ|あおぐ|fan
青白い|あおじろい|pale, pallid
垢|あか|dirt, grime
赤|あか|red
赤い|あかい|red
証|あかし|proof, evidence
赤字|あかじ|a deficit, the red
明かす|あかす|disclose, confide
あかちゃん|あかちゃん|baby
明らむ|あからむ|brighten, light
明かり|あかり|a light, an electric lamp, a lamp
上がり|あがり|rise, finish, profit
上がる|あがる|climb, rise
上がる|あがる|rise, go/climb up, make progress, improve, finish, get nervous
明るい|あかるい|bright
赤ん坊|あかんぼう|baby
秋|あき|autumn, fall
空き|あき|open, room, space
明らか|あきらか|clear, obvious, evident, plain
諦め|あきらめ|resignation, philosophy
諦める|あきらめる|resign, abandon, give up
飽きる|あきる|become tired of, lose interest in
呆れる|あきれる|be amazed/dumbfounded/flabbergasted, be shocked/astounded, be disgusted
悪|あく|evil, wickedness, vice
開く|あく|open
空く|あく|empty, vacant
握手|あくしゅ|a handshake, handshaking
アクセサリー|アクセサリー|accessories
アクセル|アクセル|accelerator
アクセント|アクセント|accent
あくどい|あくどい|vicious, wicked
あくび|あくび|a yawn
悪魔|あくま|the Devil, Satan, a fiend, an evil spirit
飽くまでも（も）|あくまで（も）|to the end/last, persistently
明くる〜|あくる〜|the next/following (day, year)
明け方|あけがた|dawn, daybreak
明ける|あける|dawn, rise, end, come to an end, be over
開ける|あける|open
あげる|あげる|give
揚げる|あげる|hoist, fly
上げる|あげる|raise, lift (up)
顎|あご|jaw, chin
憧れ|あこがれ|admiration, adoration
憧れる|あこがれる|long for, have a crush on, be attracted by
朝|あさ|morning
麻|あさ|hemp
あざ|あざ|birthmark, bruise
浅い|あさい|shallow
朝ご飯|あさごはん|breakfast
あさって|あさって|the day after tomorrow
浅ましい|あさましい|mean, ignobile, shameless
欺く|あざむく|deceive, cheat, trick
鮮やか|あざやか|vivid, bright, fine, skillful
あざわらう|あざわらう|laugh, sneer, ridicule, make fun of
足|あし|legs, foot, feet
味|あじ|taste
アジア|アジア|Asia
足跡|あしあと|a footprint, a footmark, tracks, achievement
あしからず|あしからず|I'm sorry, but…
明日|あした|tomorrow
足元|あしもと|underfoot, foothold, gait, close to
味わい|あじわい|flavour, relish
味わう|あじわう|taste, enjoy, appreciate
明日|あす|tomorrow
預かる|あずかる|keep, look after, take care of, manage, withhold
預ける|あずける|put/place/leave a thing in a person's keeping/care, enthrust, deposit
汗|あせ|sweat, perspiration
焦る|あせる|be in  a hurry, be hasty, be impatient, be anxious
褪せる|あせる|fade, discolour, fade away
あそこ|あそこ|there, that place
遊び|あそび|play (N)
遊ぶ|あそぶ|play(V)
値|あたい|value, reading
値する|あたいする|be worth, deserve
与える|あたえる|give, cause
暖かい|あたたかい|warm
暖／温かい／な|あたたかい／な|warm/hot
暖／温まる|あたたまる|become/get/grow warmer, warm up, be warmed/touched
暖／温める|あたためる|warm up, heat up
頭|あたま|head
新しい|あたらしい|new
当たり|あたり|hit (guessed right)
辺り|あたり|around, in the neighbourhood, vicinity
当たり前|あたりまえ|natural, proper, ordinary, usual, normal
当たる|あたる|hit, strike, touch, bask (in the sun), win, be in charge, be called on, be poisoned
あちこち|あちこち|here and there, all over, in many/various places, from one thing to another
あちら／あっち|あちら／あっち|this direction (polite form of あそこ)
あちらこちら|あちらこちら|here and there
あっ|あっ|oh
厚い|あつい|thick
暑い|あつい|hot
熱い|あつい|hot
悪化|あっか|change for the worse
扱い|あつかい|handle, treat, handling, managing
扱う|あつかう|treat, handle
厚かましい|あつかましい|brazen-faced, impundent, cheeky
あっけない|あっけない|disappointing, disappointingly (short)
あっさり|あっさり|simple, light, readily
圧縮|あっしゅく|compression
斡旋|あっせん|mediation
圧倒|あっとう|overwhelm, overpower
圧迫|あっぱく|pressure
アップ|アップ|close-up, improved
集まり|あつまり|meeting, group, set
集まる|あつまる|come together, gather
集める|あつめる|collect, gather
誂える|あつらえる|to order
圧力|あつりょく|pressure
当て|あて|aim, expectations
当て字|あてじ|phonetic equivalent, substitute character (kanji)
宛名|あてな|an addressee, an address
あてはまる|あてはまる|apply to, come/fall under, fit, meet, fulfill
あてはめる|あてはめる|apply, adapt to
宛てる|あてる|address (a letter to)
当てる|あてる|hit, get, apply
後|あと|after, later
後|あと|more (later)
跡|あと|trace, track, trail
跡継ぎ|あとつぎ|interior, heir
後回し|あとまわし|postponement, put off
穴|あな|a hole, a pit, a deficit, a flaw
アナウンサー|アナウンサー|announcer
あなた|あなた|you
兄|あに|(my) elder brother
姉|あね|(my) elder sister
あの|あの|used when calling out another person
あの|あの|that~
アパート|アパート|apartment
暴れる|あばれる|act violently, rage, run amok, riot, become unruly, struggle
浴びる|あびる|take a shower
危ない|あぶない|dangerous, risky, hazardous
油／脂|あぶら|oil, fat, lard, suet, tallow, grease
油絵|あぶらえ|oil painting
アフリカ|アフリカ|Africa
あぶる|あぶる|broil, roast
溢れる|あふれる|overflow, flood, be inundated, be crowded, be full of
アプローチ|アプローチ|approach
あべこべ|あべこべ|reverse, opposite
甘い|あまい|sweet
甘える|あまえる|behave like a baby, demand attention, depend on
雨具|あまぐ|rain outfit, rainwear
甘口|あまくち|sweet, mild
アマチュア|アマチュア|amateur
雨戸|あまど|a storm door, (sliding) storm shutters
甘やかす|あまやかす|indulge, be indulgent, spoil
あまり|あまり|not so
余り|あまり|the rest, the remainder, more than, over
余る|あまる|be left (over), surpass, be beyond one's power
網|あみ|net
編み物|あみもの|knitting, crochet, knitted items/goods
編む|あむ|to knit, crochet, braid, weave, compile, edit, plan, arrange
雨|あめ|rain
飴|あめ|candy
アメリカ|アメリカ|America
危うい|あやうい|dangerous, unsteady, uncertain, doubtful
怪しい|あやしい|strange, mysterious, suspicious
操る|あやつる|manage, handle, manipulate
危ぶむ|あやぶむ|fear, doubt
あやふや|あやふや|uncertain, indefinite
過ち|あやまち|mistake, error
誤[ま]り|あやまり|error, mistake
謝る|あやまる|apologise
誤[ま]る|あやまる|make a mistake, blunder
歩み|あゆみ|walking, a pace
歩む|あゆむ|walk, move through
あら|あら|aw, oh, wow, why
荒い／粗い|あらい|rough
洗う|あらう|wash
予め|あらかじめ|previously, beforehand, in advance
嵐|あらし|a storm, a difficulty, a trouble
荒らす|あらす|devastate, encroach
あらすじ|あらすじ|an outline, a brief/rough outline, a summary, a synposis
争い|あらそい|competition, struggle, quarrel
争う|あらそう|compete, contend, struggled, race, fight, dispute
新た|あらた|new, newly, renew, fresh
改まる|あらたまる|be improved, be formal, be ceremonious, be stiff, change, move
改めて|あらためて|once more, some other time, later
改める|あらためる|renew, change, reform, correct, examine, count
荒っぽい|あらっぽい|rough, violent, coarse
アラブ|アラブ|an Arab
あらゆる|あらゆる|all, every
霰|あられ|hail, a hailstone
表す|あらわす|show, express, signify, represent, symbolize, stand for
現れ|あらわれ|an expression, a manifestation, an outcome, a sign
現れる|あらわれる|appear, come out, show up
有り難い|ありがたい|appreciate, thankful, fortunate, welcome, edifying, merciful, gracious, bountiful
有り様|ありさま|a state, a condition
ありのまま|ありのまま|plain, unvarnished, frank
ありふれる|ありふれる|commonplace, ordinary
或る|ある|a certain, one, some
有る／在る|ある|have, hold
あるいは|あるいは|or, either…or, perhaps
アルカリ|アルカリ|alkali
歩く|あるく|walk
アルコール|アルコール|alcohol
アルバイト|アルバイト|part-time job
アルバム|アルバム|an album
アルミ|アルミ|aluminium
あれ|あれ|that (far listener)
あれ|あれ|that, those, ah
あれこれ|あれこれ|this and that
荒れる|あれる|be rough, be stormy
泡|あわ|bubble, foam
合わす|あわす|to adjust
合わせる|あわせる|put together, add, adjust, set, tune, adapt oneself, fit
慌ただしい|あわただしい|busy, hurried, rushed
慌てる|あわてる|be flurried
哀れ|あわれ|pity
案|あん|a plan, a proposal, an idea, expectation
安易|あんい|easy, easygoing
案外|あんがい|unexpectedly, surprisingly
暗記|あんき|memorise
アンケート|アンケート|questionnaire
アンコール|アンコール|encore
暗殺|あんさつ|assassination
暗算|あんざん|mental aritmetic
暗示|あんじ|suggestion, hint
案じる|あんじる|worry, be anxious, be concerned
安心(する)|あんしん(する)|feel relieved
安静|あんせい|rest, quiet
安全|あんぜん|safety, safe
安定|あんてい|stability, steadiness
アンテナ|アンテナ|an antenna, an aerial
あんな|あんな|like that
案内|あんない|guidance, invitation, guide, notice
案内(する)|あんない(する)|guide, show
あんなに|あんなに|such…as, so, like that
案の定|あんのじょう|just as expected, as anticipated
あんまり|あんまり|too~, so~, terrible, awful, merciless
異|い|odd
胃|い|the stomach
意|い|feelings, thinking, will, voiltion, meaning, a sense
いい|いい|good
いいえ／いえ|いいえ／いえ|no
いい加減|いいかげん|just right, inaccurate, irresponsible
言い出す|いいだす|bring up, speak out, propose, suggest
言い付ける|いいつける|order, tell, instruct, tell on
言い訳|いいわけ|explanation, excuse, justification, defense
委員|いいん|a committee, commission, committee member, commission member
医院|いいん|doctor's office, clinic
言う|いう|say, tell
家|いえ|house
家出|いえで|run away from home
以下|いか|less than
以外|いがい|except, besides
意外|いがい|unexpected, surprising
いがが|いがが|what, how about
医学|いがく|medical science
生かす|いかす|spare a person's life, revive, make use of, utilise
いかに|いかに|how, in what way, however, no matter how
いかにも|いかにも|just, as if
怒り|いかり|anger, rage, fury, wrath
粋|いき|smart, chic
行き|いき|way to
息|いき|breath, breathing
意義|いぎ|meaning, importance, significance
異議|いぎ|objection
生き生き|いきいき|fresh, lively, vivid, bright, alive
勢い|いきおい|force, energy, vigor
生き甲斐|いきがい|motivation in life, salt of life
意気込み|いきごみ|enthusiasm, determination
行き違い|いきちがい|miss each other
いきなり|いきなり|suddenly, all of a sudden, abruptly, without (any) warning
生き物|いきもの|a living thing/being, life
イギリス|イギリス|UK, England
生きる|いきる|live
行く|いく|go
幾〜|いく〜|some, many, how much
育児|いくじ|childcare, nursing
育成|いくせい|rearing, upringing, raising
幾多|いくた|numerous
幾つ|いくつ|how many
幾分|いくぶん|somewhat, a little, a part, a portion
幾ら|いくら|how much
いくら〜でも|いくら〜でも|even though ~
池|いけ|pond
生け花|いけばな|flower arrangement
いける|いける|well, not bad
意見|いけん|opinion
以後|いご|after, since, from, after this, from now on, hereafter, in (the) future
異見|いけん|different view, objection
以降|いこう|after, since, from
意向|いこう|intention
移行|いこう|a switchover, a shift
イコール|イコール|an equal sign
いざ|いざ|〜さらば goodbye, 〜という時に in a pinch, となれば私も働きます When the time comes, I will work, too
勇ましい|いざましい|brave, courageous, gallant, valiant, daring, bold, stirring
医師|いし|doctor
意思／意志|いし|a mind (to do), intention, wish, will to do, volition
石|いし|stone
維持|いじ|maintenance
意地|いじ|one's nature, wilpower, pride
意識|いしき|consciousness
虐める|いじめる|torment, bully
医者|いしゃ|doctor
移住|いじゅう|move, emigration, immigration
衣装|いしょう|clothes, clothing, costumes
以上|いじょう|more than
異常|いじょう|unusual, extraordinary, abnormal, peculiar, singular, uncommon, remarkable
衣食住|いしょくじゅう|food, clothing and shelter, creature comforts
弄る|いじる|play with, tamper
意地悪|いじわる|ill-natured, spiteful, mean
椅子|いす|chair(s)
泉|いずみ|a spring, a fountain
いずれ|いずれ|anyway, in any case, at any rate
異性|いせい|the opposite sex
遺跡|いせき|remains, ruins
以前|いぜん|before
依然|いぜん|as before, as~as ever
忙しい|いそがしい|busy
急ぐ|いそぐ|hurry, make haste
依存|いぞん|dependence (on)
板|いた|a board, a plank
痛い|いたい|painful
偉大|いだい|great, grand
委託|いたく|charge, consignment, trust
抱く|いだく|hold, embrace, hug, have, bear, entertain, harbour
致す|いたす|do (humble)
いたずら|いたずら|mischief, practical joke, prank
いただき|いただき|the top, the summit
いただきます|いただきます|Let's eat, shall we begin?
頂く|いただく|receive (humble)
いたって|いたって|extremely, very
痛み|いたみ|pain, ache, sorrow, distress
痛む|いたむ|hurt, prickle, feel prickly, sting, smart, painful
傷める|いためる|damage, spoil
炒める|いためる|fry
至る|いたる|lead to, come, extend
いたわる|いたわる|be considerate, care for
位置|いち|place, position, location
一|いち|one
市|いち|a market, a fair
いちいち|いちいち|one by one, everything, in detail
一応|いちおう|just in case, for the present time being
一概に|いちがいに|generalise
一時|いちじ|at one time, in a moment, instantly, once, for a time, for the time being
著しい|いちじるしい|remarkable
一段と|いちだんと|further, much
一度|いちど|once
一同|いちどう|all (of us)
一度に|いちどに|at once, at a time, at the same time, simultaneously, at a stretch/sitting, all together
市場|いちば|a market (place)
一番|いちばん|number one, the first, the most
一部|いちぶ|a part, a portion, partly, some
一部分|いちぶぶん|part, fraction
一面|いちめん|one side, one aspect
一目|いちもく|〜瞭然(りょうぜん) it's quite obvious, 〜置く admit one's inferiority (to a person)
一様|いちよう|uniformity
一律|いちりつ|uniformity, even
一流|いちりゅう|first-class, first-rate, the first rank
一連|いちれん|a series of, a chain of
いつ|いつ|when
一家|いっか|a home, a household, one's family
五日|いつか|the 5th day, 5 days
何時か|いつか|sometime, someday
一括|いっかつ|bulk bloc, bundle, lump
一気|いっき|burst, at a breath
一挙に|いっきょに|at a blow, at a sweep
一見|いっけん|a look, a glance, seemingly
一切|いっさい|all, everything
一昨日|いっさくじつ|the day before yesterday
一昨年|いっさくねん|the year before last, two years ago
一種|いっしゅ|a kind, a sort, a variety
一瞬|いっしゅん|an instant, a moment
一緒(に)|いっしょ(に)|together
一生|いっしょう|a lifetime, one's whole life
一生懸命|いっしょうけんめい|very hard, with all of one's might
一心|いっしん|with one's whole heart
一斉に|いっせいに|all together, all in one body, all at once, simultaneously, in unison, unanimously
いっそ|いっそ|would rather, prefer
一層|いっそう|still, even, all the more
一体|いったい|whatever, on earth, in the world
一帯|いったい|a whole (wheat fields, neighbourhood)
一旦|いったん|once
一致|いっち|agreement, accord, harmony, coincidence, correspondence
五つ|いつつ|five (counter)
一定|いってい|fixed, definite, set, uniform, regular
いってまいります／いってきます|いってまいります／いってきます|So long (lit. I'm going out and coming back)
いつでも|いつでも|any time/moment, always, at all times
いってらっしゃい|いってらっしゃい|So long. (lit. go and come back)
いつのまにか|いつのまにか|all too soon
いっぱい|いっぱい|full, much
一杯|いっぱい|enough, fill, a lot of
一般に|いっぱんに|general
一変|いっぺん|change
一方|いっぽう|one side/party, the other side/party, just goes on
いつまでも|いつまでも|forever
いつも|いつも|always
移転|いてん|a move, transfer
意図|いと|intention, purpose
糸|いと|thread
緯度|いど|latitude
井戸|いど|a well
異動|いどう|(personnel) changes
移動|いどう|move, transfer
従兄弟／従姉妹|いとこ|a (first) cousin
営む|いとなむ|cary on a business/lead a busy life
挑む|いどむ|challenge, defy
以内|いない|within (distance or time)
田舎|いなか|countryside, rural area, hometown
稲光|いなびかり|lightning
犬|いぬ|dog
稲|いね|rice, a rice plant
居眠り|いねむり|a doze
命|いのち|life
祈り|いのり|prayer, grace
祈る|いのる|to pray
威張る|いばる|boast, brag, to be proud, domineer
違反|いはん|violation, breah
いびき|いびき|a snore
衣服|いふく|clothes, dress, garments, apparel, clothing
居間|いま|living room
今|いま|now
今更|いまさら|too late to ~
未だ|いまだ|still, yet, so far
今に|いまに|soon, before long, one of those days
今にも|いまにも|any minute now
意味|いみ|meaning
移民|いみん|emigration, immmigration
イメージ|イメージ|an image, an impression
妹|いもうと|one's younger sister
妹(さん)|いもうと(さん)|younger sister
嫌|いや|dislike
嫌／否|いや|no
いやいや|いやいや|shake one's head, unwillingly
嫌がる|いやがる|dislike, hate
卑しい|いやしい|greedy, vulgar, mean, shabbily, low
いやに|いやに|suspiciously
いやらしい|いやらしい|disgusting, improper, vulgar
いよいよ|いよいよ|more and more, at last, really, assuredly
意欲|いよく|will (eagerness)
以来|いらい|since (then), ever since
依頼|いらい|a request, dependence, reliance, commission
いらいら|いらいら|nervousness, jitter, be/get irritated, become impatient
いらっしゃい(ませ)|いらっしゃい(ませ)|Welcome!, May I help you?, What can I do for you?
いらっしゃる(います)|いらっしゃる(います)|be, go, come (honorific)
入口|いりぐち|entrance
衣料|いりょう|clothing, clothes
医療|いりょう|medical treatment/care, healthcare
威力|いりょく|power, teeth
居る|いる|be, exist
要る|いる|required
煎る／炒る|いる|roast, parch, toast
衣類|いるい|clothing, clothes
入れ物|いれもの|a receptacle, a container, a case
入れる|いれる|pour (a cup of coffee)
色|いろ|color
色々|いろいろ|various
異論|いろん|differen opinion, objection, controversial
岩|いわ|a rock, a crag
祝|いわい|celebration, a festival, congratulations
祝う|いわう|congratulate, celebrate
言わば|いわば|like, a kind of, as it were, so to speak, in a manner
いわゆる|いわゆる|what is called, what they call, so-called
印鑑|いんかん|one's seal
陰気|いんき|gloom, somberness
隠居|いんきょ|retirement, retired person, the old gentleman/lady
インク／インキ|インク／インキ|ink
印刷|いんさつ|printing, typography, print
印象|いんしょう|impression
インターナショナル|インターナショナル|international
インターフォン|インターフォン|intercom
引退|いんたい|retirement
インタチェンジ|インタチェンジ|interchange
インタビュー|インタビュー|an interview
インテリ|インテリ|intellectual person, intelligentsia
インフォメーション|インフォメーション|information
インフレ|インフレ|inflation
引用|いんよう|quotation, citation
引力|いんりょく|attactive force, attraction, affinity, gravitation, magnetism, attractiveness
ウイスキー|ウイスキー|whisky
ウイルス|ウイルス|virus
ウーマン|ウーマン|a woman
ウール|ウール|wool
上|うえ|above, up, on the ~
ウエートレス／ウエイトレス|ウエートレス／ウエイトレス|a waitress
植木|うえき|a garden plant, potted plant
飢える|うえる|starve, be famished, be hungry
植える|うえる|plant
魚|うお|a fish
うがい|うがい|gargling
伺う|うかがう|ask, hear, visit (used when a speaker shows modesty)
浮[か]ぶ|うかぶ|float, surface, appear, flash
浮[か]べる|うかべる|float, launch, visualise
受かる|うかる|(in an examination) success/pass
浮く|うく|float, suspend, lose touch with, save (money)
受[け]入[れ]|うけいれ|acceptance, reception
受[け]入れる|うけいれる|receive, grant, comply with, accept, take in, admit
承る|うけたまわる|hear, comply with
受[け]継ぐ|うけつぐ|take over, inherit
受[け]付[け]|うけつけ|reception, receptionist
受[け]付ける|うけつける|accept, listen to
受[け]止める|うけとめる|catch, stop, take
受[け]取[り]|うけとり|accept, a receipt
受[け]取る|うけとる|receive, get, accept, tak, interpret, view, think
受[け]身|うけみ|passive voice
受[け]持ち|うけもち|in one's charge
受[け]持つ|うけもつ|be in charge, take charge, handle, manage, cover
受[け]る|うける|catch (a ball), receive (education, kindness, permission)
動かす|うごかす|move, shift, budge, transfer, put in action, operate, run, change, affect, manage
動き|うごき|movement, trend, sign
動く|うごく|move
兎|うさぎ|a rabbit, a hare
牛|うし|a cow
失う|うしなう|lose, miss
後ろ|うしろ|back, behind
渦|うず|whirlpool, eddy
薄い|うすい|thin
薄暗い|うすぐらい|dim, dusky
薄める|うすめる|thin, dilute, weaken
埋める|うずめる|lay low, bury
嘘|うそ|lie, untrue
嘘つき|うそつき|liar
歌|うた|song(s)
歌う|うたう|sing (a song)
疑う|うたがう|doubt, wonder, suspect
転寝|うたたね|doze, nap, snooze
うち|うち|in, of
家|うち|home
内|うち|between, among
打ち明ける|うちあける|confide, confess, tell the truth, bare
打ち合わせ|うちあわせ|arrangements
打ち合わせる|うちあわせる|knock together, arrange/discuss beforehand
打ち切る|うちきる|cut off, break off
打ち消し|うちけし|denial, negation
打ち消す|うちけす|deny, drown
打ち込む|うちこむ|beat in, dedicate oneself to, drive in, type in
宇宙|うちゅう|the universe, the cosmos, space
団扇|うちわ|a (round) fan, a round/flat paper fan
内訳|うちわけ|breakdown
打つ|うつ|type, hit, beat
うっかり|うっかり|carelessly, absentmindedly, by mistake
美しい|うつくしい|beautiful, pretty, lovely
写し|うつし|copy, duplicate
移す|うつす|move, transfer
写す|うつす|take (a picture), copy
写す／映す|うつす|copy, reflect, project
訴え|うったえ|appeal, suit
訴える|うったえる|sue, bring an action, complain, file/lodge a complaint, resort to, touch, move
うっとうしい|うっとうしい|annoying, gloomy
うつむく|うつむく|droop one's head, downcast
移る|うつる|move (from, to), change
写る／映る|うつる|come out, take, photograph, be reflected
空ろ|うつろ|hollow, vacant, blank
器|うつわ|container, receptacle, vessel
腕|うで|arm(s)
腕前|うでまえ|performance, skill
雨天|うてん|rainy (wet) weather
うどん|うどん|udon
促す|うながす|urge, press, stimulate, hasten, accelerate
うなずく|うなずく|nod
うなる|うなる|growl, groan, moan
うぬぼれ|うぬぼれ|conceit, vanity
奪う|うばう|take (a thing) by force, rob, deprive, plunder
馬|うま|horse
うまい|うまい|delicious, tasty, good at, bright, good, witty
埋まる|うまる|be buried
生まれ|うまれ|birth, one's birthplace
うまれつき|うまれつき|by nature, by birth, naturally, by constitution
生まれる|うまれる|be born
海|うみ|the sea, the ocean
有無|うむ|have or not
産む|うむ|have a baby, bear, deliver
梅|うめ|Japanese apricot, plum
埋め込む|うめこむ|implant, embed
梅干し|うめぼし|pickled plum
埋める|うめる|cove, bury, immerse, sink
敬う|うやまう|respect, esteem, look up to
裏|うら|reverse side, back
裏返し|うらがえし|reflection, reverse side, turn over, turn upside down
裏返す|うらがえす|turn over, reverse
裏切る|うらぎる|betray, be unfaithful, disappoint, fail
裏口|うらぐち|the back door
占う|うらなう|tell fortunes, do horoscopes, divine, cast, augur
恨み|うらみ|a grudge, ill will, hatred
恨む|うらむ|have/hold/bear a grudge, blame, resent
羨ましい|うらやましい|envy, enviable, be envious of
羨む|うらやむ|envy, be envious
売[り]上[げ]|うりあげ|sales
売[り]切[れ]|うりきれ|sold, sell out, out of stock
売[り]切れる|うりきれる|be sold out, be out of stock
売り出し|うりだし|bargain sale, up-and-coming, be (put) on the market
売り出す|うりだす|be put on the market, become popular
売り場|うりば|counter (in the store), booth
売る|うる|to sell
潤う|うるおう|be moistened, get well, benefit
うるさい|うるさい|noisy, annoyed
嬉しい|うれしい|glad, be happy
売れ行き|うれゆき|sales
売れる|うれる|sell, be sold, realize
うろうろ|うろうろ|loitering around
浮気|うわき|flirtation, love affair
上着|うわぎ|coat, jacket
噂|うわさ|gossip, rumour
上回る|うわまわる|exceed, be better (than), surpass, overtake
植わる|うわる|be planted
うん|うん|yes (plain form)
うん|うん|yes, yeah, ah, I've got it
運|うん|luck, fortune, fate
運営|うんえい|management, administration
運河|うんが|canal
うんざり|うんざり|tired, bored, sick
運送|うんそう|transportation, carriage
運賃|うんちん|fare
運転|うんてん|drive
運転手|うんてんしゅ|driver
うんと|うんと|a lot, much, greatly, great deal
運動(する)|うんどう(する)|exercise
云々|うんぬん|and so on, etc, comment
運搬|うんぱん|transportation, conveyance
運命|うんめい|one's fate/destiny/doom/fortune/lot
運輸|うんゆ|transportation, carriage
運用|うんよう|operation, management
絵|え|picture
柄|え|handle, grip
え(っ)|え(っ)|huh?
エアメール|エアメール|airmail
永遠|えいえん|eternity, permanence, immortality
映画|えいが|movie
映画館|えいがかん|movie theater
永久|えいきゅう|eternity, permanence
影響|えいきょう|influence, effect
営業|えいぎょう|business, trade, operation, do business
英語|えいご|English
英字|えいじ|English letter, Roman letter
映写|えいしゃ|projection
衛星|えいせい|a satellite, a moon
衛生|えいせい|hygiene, sanitation, health
映像|えいぞう|image, reflection, picture, video, tape recording, blip
英文|えいぶん|English, an English sentence
英雄|えいゆう|hero
栄養|えいよう|nutrition, nourishment
英和|えいわ|English-Japanese
ええ|ええ|yes
ええと|ええと|let me see, well, uh
笑顔|えがお|a smile
描く|えがく|draw, paint, represent, trace, outline, figure, describe, depict, think, image
液|えき|juice
駅|えき|station
液体|えきたい|a liquid, a fluid
餌|えさ|baid, food, feed
エスカレーター|エスカレーター|escalator
枝|えだ|branch
エチケット|エチケット|etiquette
閲覧|えつらん|read, browse
エネルギー|エネルギー|energy
絵の具|えのぐ|paints, colours, pigments
エプロン|エプロン|apron
獲物|えもの|game, take, bag, catch
偉い|えらい|great, admirable, serious, awful, terrible
選ぶ|えらぶ|choose
襟|えり|collar, neck
得る|える／うる|get, acquire, gain, attain, obtain, procure, win, secure
エレガント|エレガント|elegant
エレベーター|エレベーター|elevator
円|えん|yen value
縁|えん|tie, relationship, link, knot, chance, fate, destiny
宴会|えんかい|a banquet, a feast, a dinner (party)
円滑|えんかつ|smooth(ly)
縁側|えんがわ|a narrow wooden passageway (deck) along the edge of the house facing the garden
沿岸|えんがん|the coast
延期|えんき|postponement, adjournment
演技|えんぎ|acting, performance
婉曲|えんきょく|euphemistic
園芸|えんげい|gardening
演劇|えんげき|drama, play
エンジニア|エンジニア|engineer
円周|えんしゅう|circumference
演習|えんしゅう|practice, exercises, maneuvers
演出|えんしゅつ|direction (in film)
援助|えんじょ|assistance,support
演じる／ずる|えんじる／ずる|perform, enact
エンジン|エンジン|an engine
演説|えんぜつ|a speech, an address, an oration
沿線|えんせん|along (on) a railway line
演奏|えんそう|a (musical) performance, a rendering, a rendition
遠足|えんそく|an excursion, an outing, a picnic, a hike, a school excursion
縁談|えんだん|marriage proposal
延長|えんちょう|extension
煙突|えんとつ|a chimney
鉛筆|えんぴつ|pencil
遠方|えんぽう|distant place
円満|えんまん|amiable
遠慮|えんりょ|modesty, refrain, hesitate
尾|お|tail
御〜|お〜|polite marker
おい|おい|hey, hey there
甥|おい|nephew
追い掛ける|おいかける|run after, chase, pursue, follow
追い越す|おいこす|pass, get ahead of, outstrip, get ahead of, surpass
追い込む|おいこむ|druve something into
おいしい|おいしい|delicious, tasty
追い出す|おいだす|drive off, kick out
追い付く|おいつく|catch up, overtake, attain, reach
於いて|おいて|at, in, as to
おいでになる|おいでになる|come from (honorific)
オイル|オイル|oil, gasoline, gas, petrol, motor oil, suntan lotion
老いる|おいる|grow old
お祝い|おいわい|celebration, congratulations, gift
負う|おう|take responsibility, owe
王|おう|king, monarch, ruler
追う|おう|run after, chase, pursue
応援|おうえん|aid, help, support, assist, back up
応急|おうきゅう|emergency, temporary
黄金|おうごん|gold
王様|おうさま|king, a monarch, a ruler
王子|おうじ|prince
王女|おうじょ|princess
応じる／ずる|おうじる／ずる|respond to
往診|おうしん|a call on (a patient) a (doctor's) visit
応接|おうせつ|reception
応対|おうたい|reception
横断|おうだん|crossing
横断歩道|おうだんほどう|pedestrian crossing, crosswalk, zebra crossing
往復|おうふく|round trip
欧米|おうべい|Europe and America, the West
応募|おうぼ|application, entry, subscription, response, answer
応用|おうよう|(practical) application
終える|おえる|finish, complete, close, conclude, end, get through
おお|おお|oh, ooh, ah, ugh
大〜|おお〜|big, large, loud, great, roughly
おおい|おおい|hey, oh, hello, ahoy
多い|おおい|many, much, a lot of
大いに|おおいに|very (much), greatly
覆う|おおう|cover, hide, conceal, permeate
大方|おおかた|people in general
大柄|おおがら|large, big
大きい|おおきい|big
大きな|おおきな|big
オーケー|オーケー|OK, all right
大げさ|おおげさ|exaggerated
オーケストラ|オーケストラ|orchestra
おおざっば|おおざっば|roughly, broadly
大筋|おおすじ|gross outline, rough scheme
大勢|おおぜい|a crowd of people, a great/large number of people
大空|おおぞら|the sky
大通り|おおどおり|main street
オートバイ|オートバイ|motorcycle
オートマチック／オートマティック|オートマチック／オートマティック|automatic
オートメーション|オートメーション|automation
オーバー|オーバー|overcoat
オーバーする|オーバーする|go over, go past
大幅|おおはば|wide range
オープン|オープン|open, openhearted
おおまさか|おおまさか|generous, rough, approximate
大水|おおみず|a heavy flood, flooding
大家|おおや|the owner of a rented house/apartment, a landlord, a landlady
公|おおやけ|public
大凡|おおよそ|almost, roughly, generally, approximately, about, as a rule, entirely, completely
丘|おか|hill, knoll
お母さん|おかあさん|mother
お母さん／さま|おかあさん／さま|mother
おかえり(なさい)|おかえり(なさい)|welcome home, welcome back
犯す|おかす|sin, commit a (crime/sin)
侵す|おかす|invade, infringe
おかげ|おかげ|the grace of, thanks to, owe to
おかけください|おかけください|Please sit down, please be seated, please take your seats
おかけさまで|おかけさまで|by the grace of, thanks to, owing to
お菓子|おかし|sweets, snacks
おかしい|おかしい|amusing, funny, strange, odd
おかず|おかず|a (side) dish
お金|おかね|money
お構いなく|おかまいなく|Please don't go to any trouble
拝む|おがむ|worship, pray, implore,see
お代わり|おかわり|a second helping, seconds
沖|おき|the offing, the open sea
補う|おぎなう|supplement, make up for, offset, compensate
お気の毒に|おきのどくに|I'm (so) sorry
起きる|おきる|wake up, get up/happen, occur, take place, be caused, originate
億|おく|hundred million
置く|おく|put
奥|おく|the inner part, deep, at the end, behind, bosom
屋外|おくがい|outdoors, in the open, out of doors
奥さん|おくさん|wife
奥さん／さま|おくさん／さま|(your/his) wife, housewife
屋上|おくじょう|roof
臆病|おくびょう|cowardice, timidity
遅らす|おくらす|delay, postpone, wait
送り仮名|おくりがな|conjugational kana added after a Chinese character
贈り物|おくりもの|present
送る|おくる|send off
贈る|おくる|give, present, confer, award
遅れ|おくれ|delay
遅れる|おくれる|be late for
おげんきで|おげんきで|Good luck!, Take care of yourself
お元気ですか|おげんきですか|How are you?
お子さん|おこさん|one's child
起こす|おこす|wake someone up
厳か|おごそか|solemn, stately
怠る|おこたる|neglect
行い|おこない|act, conduct
行う|おこなう|do, conduct
起こる|おこる|happen, occur
怒る|おこる|get angry (scold)
おごる|おごる|treat, proud, arrogant
押さえる|おさえる|hold, steady, stop, press, cover, catch, arrest, grasp
おさきに|おさきに|excuse me, but I must be going
幼い|おさない|young, immature
収／治／納まる|おさまる|pack, go, stay in, be settled
収／治／納める|おさめる|put, keep, obtain, gain / suppress, rule, reign /accept, supply, pay, finish
お産|おさん|give birth to a baby
伯父／叔父(さん)|おじ(さん)|uncle
惜しい|おしい|① 貴重で失いたくない。② あと一息のところで物事が成就せず残念だ。③ 心残りだ。いつまでも未練が残る。
おじいさん|おじいさん|old man, grandfather
押入れ|おしいれ|closet
教え|おしえ|teaching, lesson
教える|おしえる|to teach
押し込む|おしおむ|plunge, push into
御辞儀|おじぎ|a bow, curtsy
押し切る|おしきる|break down
伯父／叔父／小父さん|おじさん|uncle, mister
惜しむ|おしむ|spare, grudge, be reluctant to
おしゃべり|おしゃべり|chat, prattle, talkative
お邪魔します|おじゃまします|Hello! May I come in?
おしゃれ|おしゃれ|fashionable, smart
お嬢さん|おじょうさん|one's daughter, young lady
押し寄せる|おしよせる|crowd into, surge ahead
押す|おす|push, thrust, shove, press, stamp
雄|おす|male, bull
お世辞|おせじ|compliment, flattery
お世話になりました|おせわになりました|Thank you for your (kind) help/assistance
汚染|おせん|pollution, contamination
遅い|おそい|late, slow
襲う|おそう|attack
遅くとも|おそくとも|at the latest
恐らく|おそらく|probably, perhaps
恐れ|おそれ|fear, dread, terror, fright
恐れ入る|おそれいる|be sorry, be greatly impressed, be dumbfounded, be amazed, be fed up with
恐れる|おそれる|fear, scare, dread, be afraid of, reverence
恐ろしい|おそろしい|terrible, horrible, dreadful, fierce, ferocious, formidable, trememdous, awful
教わる|おそわる|learn, be taught
お大事に|おだいじに|Take (good) care of yourself
お互い(に)|おたがい(に)|each other, one another
お宅|おたく|one's home
おだてる|おだてる|flatter
穏やか|おだやか|calm, quiet, moderate, peaceful, gentle, mild-mannered
落ち込む|おちこむ|fall into, fall in, sink, in low spirits, be depressed/despondent
落ち着き|おちつき|composure, balance, calmness
落ち着く|おちつく|become composed, settle, calm, conclusion
落ち葉|おちば|fallen leaves
お茶|おちゃ|japanese tea
落ちる|おちる|fall
乙|おつ|the second best
お使い|おつかい|run on errands
おっかない|おっかない|scary
おっしゃる|おっしゃる|say (honorific)
夫|おっと|one's husband
お釣り|おつり|change
お手上げ|おてあげ|be done for, hopeless
お手洗い|おてあらい|restroom
お出掛け|おでかけ|go out
お手伝いさん|おてつだいさん|a maid, a domestic helper
音|おと|sound
お父さん|おとうさん|father
お父さん／さま|おとうさん／さま|father
弟|おとうと|younger brother
弟(さん)|おとうと(さん)|younger brother
おどおど|おどおど|tremble with fear
おどかす|おどかす|threaten, menace, scare, startle, frighten
男|おとこ|male
男の子|おとこのこ|boy
男の人|おとこのひと|male
落とし物|おとしもの|a lost article
落とす|おとす|drop, lose
おどす|おどす|threaten
訪れる|おどずれる|visit, come
おととい|おととい|the day before yesterday
おととし|おととし|the year before last
大人|おとな|adult
大人しい|おとなしい|well-behaved, gentle, quiet
お供／伴|おとも|go along with, accompany
踊り|おどり|dance
劣る|おとる|be inferior, behind, below, beneath
踊る|おどる|to dance
衰える|おとろえる|become weaker, decine
驚かす|おどろかす|surprise, take a person by surprise, astonish, amaze, shock, frighten, terrify
驚き|おどろき|surprise, amazement, wonder
驚く|おどろく|be surprised
同い年|おないどし|same age
お腹|おなか|stomach
同じ|おなじ|the same (as)
鬼|おに|an ogre, a devil, a demon, a fiend
お兄さん|おにいさん|elder brother
お姉さん|おねえさん|elder sister
お願いします|おねがいします|Please do…, I would like you to…, Could I ask you to…
各々|おのおの|each person, everyone
自ずから|おのずから|naturally, by itself
伯母／叔母(さん)|おば(さん)|aunt
おばあさん|おばあさん|old woman, grandmother
伯母／叔母／小母|おばさん|an aunt, a lady, Madam
おはよう(ございます)|おはよう(ございます)|Good morning
帯|おび|an obi, a broad sash (tied over a kimono), a belt
怯える|おびえる|be frightened
夥しい|おびただしい|a large quantity of, tremendous
脅かす|おびやかす|intimidate, terrify
お昼|おひる|noon, daytime, lunch
帯びる|おびる|wear, carry, be charged, take on
オフィス|オフィス|office
お袋|おふくろ|mother, mom, homemade
御風呂|おふろ|bath, bathroom
お弁当|おべんとう|lunch box
覚え|おぼえ|learning, memorising, memory
覚える|おぼえる|learn, remember, memorise
溺れる|おぼれる|drown
お参り|おまいり|visit (a person's grave)
おまえ|おまえ|you (from superior to subordinate)
おまけ|おまけ|addition, something extra
おまたせしました|おまたせしました|Thank you for waiting.
おまちください|おまちください|Please wait
おまちどおさま|おまちどおさま|Thank you for waiting.
お祭り|おまつり|festival
おまわりさん|おまわりさん|policeman
お見舞い|おみまい|inquiry, expression of one's sympathy
お宮|おみや|Japanese shrine
お土産|おみやげ|souvenir
おむつ|おむつ|diaper
おめでたい|おめでたい|happy, joyous, auspicious, simple, naïve
おめでとう(ございます)|おめでとう(ございます)|Congratulations!
お目にかかる|おめにかかる|meet, see (senior, superior)
主(な/に)|おも(な/に)|main, principal, mainly, chiefly
重い|おもい|heavy (weight), serious (illness)
思い掛けない|おもいがけない|unexpected, unforseen
思い込む|おもいこむ|imagine, assume, take… for…
思い出す|おもいだす|remember, recall
思い付き|おもいつき|idea, plan, casual idea
思いっ切り|おもいっきり|to one's heart's content, to the best of one's ability
思い付く|おもいつく|think of, hit on, fall on, strike on, occur to one, remember, guess, conceive
思い出|おもいで|a memory, recollections
思う|おもう|think
面白い|おもしろい|interesting, funny
重たい|おもたい|heavy, depressing
おもちゃ|おもちゃ|toy
表|おもて|front, right side, face
趣|おもむき|flavor, appearance, charm
赴く|おもむく|go, proceed, get
思わず|おもわず|unconciously, in spite of oneself, instinctively
重んじる／ずる|おもんじる／ずる|value, treasure, prize, make much of, think much of
おや|おや|Oh!
親|おや|parents, father, mother
親父|おやじ|one's father
お休み(なさい)|おやすみ(なさい)|Good night.
おやつ|おやつ|a snack, refreshments
親指|おやゆび|the thumb, the big toe
泳ぎ|およぎ|swimming
泳ぐ|およぐ|swim (in the pool)
およそ|およそ|almost, roughly, generally, approximately, about, as a rule, entirely, completely
及び|および|and, as well as
及ぶ|およぶ|be equal to, reach, extend
及ぼす|およぼす|exert, influence, affect
折|おり|on occasion, at a time of
檻|おり|cage
オリエンテーション|オリエンテーション|orientation
折り返す|おりかえす|fold back, turn down, return
織物|おりもの|textiles, (textile) fabrics, cloth
降りる|おりる|get off
下りる|下りる|get down (a mountain, descend)
オリンピック|オリンピック|the Olympic Games, the Olympics
居る|おる|to be (humble form of いる)
織る|おる|weave
折る|おる|bend, break
オルガン|オルガン|organ, pipe organ, harmonium, reed organ
俺|おれ|I (make speaker's term for I)
お礼|おれい|thanks, appreciation
折れる|おれる|be folded
オレンジ|オレンジ|orange
愚か|おろか|foolish, silly, stupid
卸す|おろす|wholesale
下ろす／降ろす|おろす|take down, lower, pull down, withdraw
おろそか|おろそか|negligent
お詫び|おわび|an apology
終わり|おわり|end
終わる|おわる|end, be over, finish
恩|おん|a favor, kindness, an obligaiton, moral indebtness
音|おん|sound, noise
音楽|おんがく|music
恩恵|おんけい|a favor, a benefit, a blessing
温室|おんしつ|greenhouse
温泉|おんせん|hot spring
温帯|おんたい|temperate zone
温暖|おんだん|warm, mild
御中|おんちゅう|郵便物で，会社・団体など個人名以外のあて名の下に添える語。「○○株式会社人事課―」
温度|おんど|temperature, heat
女|おんな|female
女の子|おんなのこ|girl
女の人|おんなのひと|woman, lady, female
女の人|おんなのひと|female
おんぶ|おんぶ|carry a person on one's back
オンライン|オンライン|online
温和|おんわ|mild, gentle
課|か|section, department, lesson
蚊|か|mosquito
可|か|may, will, fair, passable
画〜|が〜|something related to pictures
カー|カー|car
カーテン|カーテン|curtain
カード|カード|card
カーブ|カーブ|curve
カーペット|カーペット|carpet
貝|かい|shellfish, shell
害|がい|harm, damage
外〜|がい〜|outside
改悪|かいあく|change for the worse
会員|かいいん|member of society, member of association, membership
海運|かいうん|shipping, marine transportation
絵画|かいが|picture, painting, drawing
外貨|がいか|foreign currency
開会|かいかい|the opening of a meeting, the opening of a session
海外|かいがい|overseas
改革|かいかく|reform
貝殻|かいがら|shell, seashell
会館|かいかん|hall, assembly hall
海岸|かいがん|seashore, beach
外観|がいかん|outward appearance
会議|かいぎ|conference
会議室|かいぎしつ|conference room
階級|かいきゅう|class, rank
海峡|かいきょう|strait, channel
会計|かいけい|account, bill
解決|かいけつ|settlement, solution, resolution
会見|かいけん|interview
介護|かいご|nursing, care
会合|かいごう|gathering, meeting
外交|がいこう|diplomacy, foreign policy, diplomatic relations
外国|がいこく|foreign country
外国人|がいこくじん|foreigner
開催|かいさい|hold, open a meeting
改札|かいさつ|wicket, ticket gate
解散|かいさん|break up, disperse, dissolve
開始|かいし|an opening, a beginning, commencement
会社|かいしゃ|company
解釈|かいしゃく|interpretation
回収|かいしゅう|collection, withdrawal
改修|かいしゅう|repair
怪獣|かいじゅう|monster
外出|がいしゅつ|go out
解除|かいじょ|cancellation, release
外相|かいしょう|Foreign Minister
会場|かいじょう|meeting place, grounds, hall
海水浴|かいすいよく|sea bathing
回数|かいすう|the number of times
回数券|かいすうけん|coupon ticket, book of coupon tickets
害する|がいする|harm, spoil
快晴|かいせい|fine/fair weather
改正|かいせい|revision, reform, amendment
解説|かいせつ|explanation, commentary
概説|がいせつ|outline
改善|かいぜん|improvement, betterment
回送|かいそう|forward, deadhead, drive without passengers
階層|かいそう|story, level
改造|かいぞう|remodelling
開拓|かいたく|reclamation, cultivation, development, explore
会談|かいだん|conference, meeting, talk, summit
階段|かいだん|stairs
開通|かいつう|be opened to/for traffic
改定|かいてい|revision (of rules)
改訂|かいてい|revision (e.g. revised edition)
快適|かいてき|comfortable, pleasant
回転|かいてん|revolution, rotation, a roll, circulation, turnover
ガイド|ガイド|guide
解答／回答|かいとう|answer, solution
街道|かいどう|highway, thoroughfare, trunk road
街頭|がいとう|the street
該当|がいとう|applicable, relevant
ガイドブック|ガイドブック|guidebook
介入|かいにゅう|intervention
概念|がいねん|general idea, notion, concept
開発|かいはつ|development, exploitation
海抜|かいばつ|sea level
外部|がいぶ|the outside, the outside world
回復|かいふく|restoration, rehabilitation, recovery
介抱|かいほう|nursing, care
解放|かいほう|liberation, emancipation
開放|かいほう|open (a country, an economy)
解剖|かいぼう|dissection, autopsy
買い物|かいもの|shopping
買い物(する)|かいもの(する)|shop, purchase
海洋|かいよう|the ocean
概要|がいよう|outline, summary
外来|がいらい|foreign, something from outside
回覧|かいらん|circulation
概略|がいりゃく|outline, summary
海流|かいりゅう|ocean current
改良|かいりょう|improvement, reform
回路|かいろ|circuit
海路|かいろ|sea route
概論|かいろん|an outline, an introduction
会話|かいわ|conversation
飼う|かう|raise, keep
買う|かう|buy (something)
帰す|かえす|let (a person) go back
返す|かえす|return (something) to (someone)
却って|かえって|on the contrary, instead, rather, all the more
帰り|かえり|return
顧みる／省みる|かえりみる|reflect on, search one's soul
換える|かえる|exchange, change
代える／替える|かえる|subsitute, instead of, in place of
返る|かえる|return, be returned, regain, come back
変える|かえる|change
帰る|かえる|return, come back
顔|かお|face
家屋|かおく|a house
顔付き|かおつき|features, looks, expression
香り|かおり|fragrance, scent, smell, perfume, aroma, bouquet
画家|がか|a painter
課外|かがい|extracurricular
抱える|かかえる|hold, have, with, hire, employ, keep
価格|かかく|price, cost, value
化学|かがく|chemistry
科学|かがく|science
掲げる|かかげる|put up, display
かかと|かかと|heel
鏡|かがみ|mirror
輝く|かがやく|shine, twinkle, glitter, sparkle
係|かかり|a person in charge
掛かる|かかる|hang
掛かる／罹る|かかる|fall (lit. be taken) (ill)
係[わ]る|かかわる|have to do with, be involved in
鍵|かぎ|key
書留|かきとめ|registered mail, registered post, a registered leter
書き取り|かきとり|dictation
書き取る|かきとる|write down, take a dictation
垣根|かきね|a fence, a hedge
掻き回す|かきまわす|stir up
限り|かぎり|limit
限る|かぎる|limit, restrict
(汗を)かく|かく|sweat, perspire
(恥を)かく|かく|be disgraced, be humiliated
欠く|かく|break, chip, lack
掻く|かく|scratch, shovel away
格|かく|status, rank, rule
角|かく|angle, square
書く／描く|かく|write, spell, compose, draw, paint
核|かく|原子核。
家具|かぐ|furniture
嗅ぐ|かぐ|smell (at)
覚悟|かくご|preparedness, readiness, resolution
格差|かくさ|difference, gap
拡散|かくさん|diffusion
各自|かくじ|each person, everyone
学士|がくし|bachelor's degree
確実|かくじつ|certain, sure, reliable, sound (business)
学者|がくしゃ|scholar
各種|かくしゅ|various kinds
隔週|かくしゅう|biweekly, fortnightly
拡充|かくじゅう|expansion
学習|がくしゅう|study
学術|がくじゅつ|arts and sciences, learning, scholarship, one's studies
革新|かくしん|reform, innovation
確信|かくしん|conviction, confidence
隠す|かくす|conceal, hide, cover
学生|がくせい|student
学説|がくせつ|theory, doctrine
拡大|かくだい|magnification, expansion
各地|かくち|various places
拡張|かくちょう|extension, expansion, enlargement
確定|かくてい|(made a) decision
カクテル|カクテル|cocktail
角度|かくど|angle
獲得|かくとく|acquisition
確認|かくにん|confirmation
学年|がくねん|school year, grade
楽譜|がくふ|sheet music
学部|がくぶ|academic department, faculty
格別|かくべつ|particularly, especially
確保|かくほ|secure
革命|かくめい|revolution
学問|がくもん|learning, study, education
確率|かくりつ|probability
確立|かくりつ|establishment
学力|がくりょく|scholastic/academic ability
学歴|がくれき|one's school/academic background
隠れる|かくれる|be hidden, to hide
〜掛け|〜かけ|half-done, hanger
賭け|かけ|bet, wager, gamble
掛け〜|かけ〜|credit, installment, premium
影／陰|かげ|shade, shadow
崖|がけ|cliff
駆け足|かけあし|run, gallop
家計|かけい|family budget
掛け算|かけざん|multiplication
可決|かけつ|approval, adoption
〜か月／〜箇月|〜かげつ|months
かけっこ|かけっこ|race
駆ける|かける|run, gallop (verb)
賭ける|かける|bet, stake
掛ける|かける|hung
掛ける|かける|make (a phone call)
掛ける|かける|wear (spectacles)
掛ける|かける|lock (a door)
掛ける|かける|sit (on a chair)
掛ける|かける|cause someone worry
掛ける|かける|spend, cost
掛ける|かける|声を〜
掛ける|かける|音楽を〜
掛ける|かける|振り〜
欠ける|かける|break off, chip off, wane, lack
加減|かげん|adjustment, moderation, degree
過去|かこ|the past
籠|かご|basket, cage
下降|かこう|descent, fall, decline
火口|かこう|crater
加工|かこう|processing, manufacturing
化合|かごう|chemical compound
囲む|かこむ|encircle, surround, wall in, fence, besiege
傘|かさ|umbrella
火災|かさい|fire (disaster)
重なる|かさなる|to overlap
重ねる|かさねる|to stack, to pile up
かさばる|かさばる|be bulky
かさむ|かさむ|mount, run up
飾り|かざり|decoration
飾る|かざる|to decorate
火山|かざん|volcano
菓子|かし|sweets
貸し|かし|Loan
火事|かじ|Fire (incident)
家事|かじ|Housework
賢い|かしこい|Wise
かしこまりました|かしこまりました|yes sir, certainly, with pleasure
貸し出し|かしだし|a loan, lending
過失|かしつ|Mistake
果実|かじつ|Fruit
貸し間|かしま|Room for rent, room to let
貸家|かしや|House for rent, house to let
歌手|かしゅ|Singer
箇所|かしょ|Place
過剰|かじょう|Excess
箇条書き|かじょうがき|Itemization
頭|かしら|Head
齧る|かじる|to gnaw, crunch on, bite off, nibble
貸す|かす|To lend
数|かず|Number
ガス|ガス|gas
微か|かすか|faint, dim, slight
霞む|かすむ|be hazy (misty), mist over
擦る|かする|To rub
風邪|かぜ|Cold (illness)
風|かぜ|Wind
火星|かせい|Mars
課税|かぜい|Taxation
化石|かせき|Fossil
稼ぐ|かせぐ|To earn
カセット (テープ)|カセット (テープ)|Cassette (Tape)
下線|かせん|Underline
化繊|かせん|Synthetic fiber
河川|かせん|River
過疎|かそ|Depopulation
数える|かぞえる|To count
加速|かそく|Acceleration
家族|かぞく|Family
加速度|かそくど|Acceleration rate
ガソリン|ガソリン|gasoline
ガソリンスタンド|ガソリンスタンド|gas station
〜方|〜かた|polite form of person
〜方|〜かた|the way to (do)
型|かた|Model / Type
肩|かた|Shoulder
片〜|かた〜|one side
固い／硬い／堅い|かたい|hard
課題|かだい|subject, homework, assignment
〜難い|がたい|difficult/hard to do
片思い|かたおもい|Unrequited love
方々|かたがた|Various people
片仮名|かたかな|Katakana
片言|かたこと|Prattle
形|かたち|Shape, figure
片付く|かたづく|To be tidied up
片付け|かたづけ|Put in order, put away, tidy
片付ける|かたづける|To tidy up
刀|かたな|Sword
塊|かたまり|Lump / Mass
固まる|かたまる|Harden, become solid/stiff
片道|かたみち|One-way trip
傾く|かたむく|To tilt
傾ける|かたむける|To lean
固める|かためる|To solidify
片寄る|かたよる|lean, be prejudiced
語る|かたる|talk, tell, narrate, recite, show
傍ら|かたわら|the side, beside
花壇|かだん|Flower bed
価値|かち|Value
勝ち|かち|victory, win
〜がち|〜がち|tend to do
家畜|かちく|Livestock
課長|かちょう|Section manager
勝つ|かつ|To win
且つ|かつ|moreover
〜月|〜がつ|months of a year
学科|がっか|Subject
学会|がっかい|Academic meeting
がっかり|がっかり|be discouraged
活気|かっき|Vigor
画期|かっき|epoch-making
学期|がっき|Semester
楽器|がっき|Musical instrument
学級|がっきゅう|Class (in school)
担ぐ|かつぐ|To carry
がっくり|がっくり|be heartbroken
括弧|かっこ|Parentheses
格好|かっこう|Appearance
学校|がっこう|School
活字|かつじ|Printed type
合唱|がっしょう|Chorus
がっしり|がっしり|Solidly
合致|がっち|Agreement
がっちり|がっちり|Firmly
勝手|かって|One's own way
かつて|かつて|once, at once
勝手に|かってに|Arbitrarily
活動|かつどう|Activity
活発|かっぱつ|Active
活発|かっぱつ|Lively
カップ|カップ|Cup
合併|がっぺい|Merger
活躍|かつやく|Active participation
活用|かつよう|Application
活力|かつりょく|Vitality
家庭|かてい|Household
課程|かてい|Curriculum
過程|かてい|Process
仮定|かてい|Assumption
過程|かてい|Course / Process
仮定|かてい|Hypothesis
カテゴリー|カテゴリー|Category
角|かど|Corner
仮名|かな|Kana (Japanese syllabary)
叶う|かなう|To be fulfilled
叶える|かなえる|To fulfill
悲しい|かなしい|Sad
悲しむ|かなしむ|To grieve
仮名遣い|かなづかい|Kana usage
金槌|かなづち|Hammer
必ず|かならず|Certainly, surely, without fail
必ずしも|かならずしも|Not necessarily
かなり|かなり|Pretty, fairly, rather
かなわない|かなわない|Impossible
かにゅう|かにゅう|Entry
鐘|かね|bell
金|かね|metal, money
かねつ|加熱|Heating
予て|かねて|Previously
～かねない|～かねない|Might happen
金持ち|かねもち|Wealthy
兼ねる|かねる|Combine
可能|かのう|Possible
彼女|かのじょ|She
カバー|カバー|Cover
庇う|かばう|Protect
かばん|かばん|Bag
過半数|かはんすう|Majority
かび|かび|Mold
花瓶|かびん|vase
株|かぶ|Stock
株式|かぶしき|Share
被せる|かぶせる|Cover
かぶる|かぶる|Wear
かぶれる|かぶれる|get a rash
花粉|かふん|Pollen
かべ|かべ|Wall
貨幣|かへい|Currency
釜|かま|Kettle
かまいません|かまいません|care about, mind
かまいません|かまいません|I don't mind
構う|かまう|Mind
構え|かまえ|structure, stance
構える|かまえる|Prepare
我慢|がまん|Patience
紙|かみ|Paper
髪|かみ|Hair
神|かみ|God
上|かみ|Upper
加味|かみ|Consideration
噛み切る|かみきる|Bite off
紙屑|かみくず|Waste paper
神様|かみさま|Deity
剃刀|かみそり|Razor
過密|かみつ|Overcrowded
雷|かみなり|Thunder
髪の毛|かみのけ|Hair strand
噛む|かす|Chew
ガム|ガム|Gum
カムバック|カムバック|Comeback
カメラ|カメラ|Camera
カメラマン|カメラマン|Cameraman
科目|かもく|Subject
かもしれない|かもしれない|Might be
貨物|かもつ|Cargo
粥|かゆ|Porridge
かゆい|かゆい|Itchy
通う|かよう|Commute
歌謡|かよう|Song
火曜|かよう|Tuesday
火曜日|かようび|Tuesday
殻|から|Shell
空|から|Empty
柄|がら|Pattern
カラー|カラー|Color
辛い|からい|Spicy
からかう|からかう|Tease
ガラス|ガラス|Glass
体|からだ|Body
体付き|からだつき|Physique
空っぽ|からっぽ|Empty
絡む|からむ|Entangle
借り|かり|Borrow
狩り|かり|Hunt
仮|かり|Temporary
借りる|かりる|To borrow
刈る|かる|To cut
～がる|～がる|Feeling like
軽い|かるい|Light
かるた|かるた|Card game
カルテ|カルテ|Medical record
彼|かれ|He
カレー|カレー|Curry
ガレージ|ガレージ|Garage
彼ら|かれら|They
枯れる|かれる|Wither
涸れる|かれる|Dry up
カレンダー|カレンダー|Calendar
過労|かろう|Overwork
かろうじて|かろうじて|Barely
カロリー|カロリー|Calorie
皮/革|かわ|Skin/Leather
側|～がわ|Side
かわいい|かわいい|Cute
かわいがる|かわいがる|Adore
かわいそう|かわいそう|Pitiful
かわいらしい|かわいらしい|Lovely
乾かす|かわかす|Dry
乾く/渇く|かわく|Dry/thirsty
かわず|かわず|Frog
交わす|かわせ|Exchange
為替|かわせ|Foreign exchange
瓦|かわら|Tile
